./assets/world.png
32
32
40
40
29 29 29 29 29 29 29 29 29 29 29 29 29 29 29 29 29 29 29 29 29 29 29 29 13 14 15 29 29 29 29 29 29 29 29 29 29 29 29 29
29 29 29 29 29 29 29 29 29 29 29 29 29 29 29 29 29 29 29 29 29 29 29 45 13 14 15 29 30 29 29 29 29 29 29 29 29 29 29 29
29 29 29 29 29 29 29 29 29 29 29 29 29 29 29 29 29 29 29 29 29 29 29 29 13 14 15 29 29 29 29 29 29 29 29 29 29 29 29 29
29 29 29 29 29 29 29 29 29 29 29 29 29 29 29 29 29 29 29 29 29 29 29 30 21 22 23 29 29 29 29 29 29 29 29 29 29 29 29 29
29 29 29 29 29 29 29 29 29 29 29 29 29 29 29 29 29 29 29 29 29 29 29 29 0 1 2 29 29 30 29 29 29 29 29 29 29 29 29 29
29 29 29 29 29 29 29 29 29 29 29 24 25 25 25 25 25 25 25 25 25 25 25 26 8 9 10 29 29 29 29 29 29 29 29 29 29 29 29 29
29 29 29 29 29 29 29 29 29 29 29 32 33 33 33 33 33 33 33 33 33 33 33 34 8 9 10 29 29 29 29 29 29 29 29 29 29 29 29 29
29 29 29 29 29 29 39 29 29 29 29 32 33 35 41 36 33 33 33 33 33 33 33 34 8 9 10 29 29 29 29 29 29 29 29 29 29 29 29 29
29 29 29 29 29 29 29 29 29 29 29 32 33 34 29 32 33 33 33 33 33 33 33 34 8 9 10 29 29 29 29 29 29 29 29 29 29 29 29 29
29 29 29 29 29 29 29 29 37 29 29 32 33 34 29 32 33 33 33 33 33 33 33 34 8 9 10 29 29 29 29 29 29 29 29 29 29 29 29 29
29 29 29 29 29 47 37 29 29 29 29 32 33 43 25 44 33 33 33 33 33 33 33 34 8 9 10 29 29 29 29 29 29 29 29 29 29 29 29 29
29 29 29 39 29 29 29 39 29 29 29 32 33 33 33 33 33 33 33 35 41 36 33 34 8 9 10 29 29 29 29 29 29 29 29 29 29 29 29 29
39 29 29 29 29 39 37 29 29 37 29 32 33 33 33 33 33 33 33 43 25 44 33 34 8 9 10 29 29 29 29 29 29 29 29 29 29 29 29 29
29 38 29 29 29 37 29 39 29 29 29 32 33 33 33 33 33 33 33 33 33 33 33 34 8 9 10 29 29 29 29 29 29 29 29 29 29 29 29 29
29 29 29 38 29 29 29 29 29 29 29 40 41 41 41 41 41 41 41 41 41 41 41 42 8 9 10 29 29 29 29 29 29 29 29 29 29 29 29 29
6 6 7 0 1 1 1 1 1 1 1 1 2 0 1 1 1 1 1 1 1 1 1 1 28 9 10 29 29 29 29 29 29 29 29 29 29 29 29 29
14 14 15 8 9 9 9 9 9 9 9 9 10 8 9 9 9 9 9 9 9 9 9 9 9 9 10 29 29 29 29 29 29 29 29 29 29 29 29 29
22 22 23 16 17 17 17 17 17 17 17 17 18 16 17 17 17 17 17 17 17 17 17 17 17 17 18 29 29 29 29 29 29 29 29 29 29 29 29 29
29 29 38 29 29 29 29 29 29 29 29 29 29 29 29 29 29 29 29 29 29 29 29 29 29 29 29 29 29 29 29 29 29 29 29 29 29 29 31 30
29 29 29 29 38 29 29 29 29 29 29 29 29 29 29 29 29 29 29 29 29 29 29 29 29 29 29 29 29 29 29 29 29 29 29 29 29 29 29 31
38 29 29 29 29 29 29 29 29 29 29 29 29 29 29 29 29 29 29 29 29 29 29 29 29 29 24 25 25 25 25 25 25 25 25 25 25 25 26 29
29 29 29 29 29 29 29 29 29 29 29 29 29 29 29 29 29 29 29 29 29 29 29 29 45 29 32 33 33 33 33 33 33 33 33 35 41 36 34 29
29 29 29 29 29 29 29 29 29 29 29 29 29 29 29 29 29 29 29 29 29 29 29 29 29 29 32 33 33 33 33 33 33 33 33 34 47 32 34 29
29 29 29 29 29 29 29 29 29 29 29 29 29 29 29 29 29 29 29 29 29 29 29 29 29 46 32 33 33 33 33 33 33 33 33 34 47 32 34 29
29 29 29 29 29 29 29 29 29 29 29 29 29 29 29 29 29 29 29 29 29 29 38 29 29 29 32 33 33 33 33 33 33 33 33 34 47 32 34 29
29 29 29 29 29 29 29 29 29 29 29 29 29 29 29 29 29 29 29 29 29 29 29 29 29 29 32 33 33 33 33 33 33 33 33 43 25 44 34 29
29 29 29 29 29 29 29 29 29 29 29 29 29 29 29 29 29 29 29 29 29 29 29 29 46 29 32 33 33 33 33 33 33 33 33 33 33 33 34 29
29 29 29 29 29 29 29 29 29 29 29 29 29 29 29 29 29 29 29 29 29 29 29 29 29 29 32 33 33 33 33 33 33 33 33 33 33 33 34 47
29 29 29 29 29 29 29 29 29 29 29 29 29 29 29 29 29 29 29 29 29 29 29 29 29 29 32 33 33 33 33 33 33 33 33 33 33 33 34 29
29 29 29 29 29 29 29 29 29 29 29 29 29 29 29 29 29 29 29 29 29 29 29 29 29 29 40 41 41 41 41 41 41 41 41 41 41 41 42 29
29 29 29 29 29 29 29 29 29 29 29 29 29 29 29 29 29 29 29 29 29 29 29 29 29 29 29 29 29 29 29 29 29 29 29 29 29 29 29 29
29 29 29 29 29 29 29 29 29 29 29 29 29 29 29 29 29 29 29 29 29 29 29 29 29 29 29 29 29 29 29 29 29 29 29 29 31 29 29 29
29 29 29 29 29 29 29 29 29 29 29 29 29 29 29 29 29 29 29 29 29 29 29 29 29 29 29 29 29 29 29 29 29 29 29 29 29 29 29 29
29 29 29 29 29 29 29 29 29 29 29 29 29 29 29 29 29 29 29 29 29 29 29 29 29 29 29 29 29 29 29 31 29 29 29 30 29 29 29 29
29 29 29 29 29 29 29 29 29 29 29 29 29 29 29 29 29 29 29 29 29 29 29 29 29 29 29 29 29 29 29 29 29 29 29 29 29 31 29 29
29 29 29 29 29 29 29 29 29 29 29 29 29 29 29 29 29 29 29 29 29 29 29 29 29 29 29 29 29 29 29 29 29 29 29 29 29 29 29 29
29 29 29 29 29 29 29 29 29 29 29 29 29 29 29 29 29 29 29 29 29 29 29 29 29 29 29 29 29 29 29 29 29 29 29 29 29 29 29 29
29 29 29 29 29 29 29 29 29 29 29 29 29 29 29 29 29 29 29 29 29 29 29 29 29 29 29 29 29 29 29 29 29 29 29 29 29 29 29 29
29 29 29 29 29 29 29 29 29 29 29 29 29 29 29 29 29 29 29 29 29 29 29 29 29 29 29 29 29 29 29 29 29 29 29 29 29 29 29 29
29 29 29 29 29 29 29 29 29 29 29 29 29 29 29 29 29 29 29 29 29 29 29 29 29 29 29 29 29 29 29 29 29 29 29 29 29 29 29 29